11111
11111
11111
55555
00000
00000
11111
11111
12121
11111
11111
11111
21212
11111
11111
11111
21111
12111
11211
11121
11111
11111
11112
11121
11211
12111
11111
11111
11111
3
11111
11111
11111
12121
12121
12121
12121
11111
4
4
11111
11111
11111
11111
11111
3
3
11111
11111
11111
11111
11111
22122
12121
12121
12121
12121
12121
12121
12121
11111
11111
11111
11111
00700
00700
00700
00700
00700
00770
00770
00070
00070
00070
00070
00070
00070